11111111111111111111111111111111111111111111111111111111111111
10000000000000000000000000000000000000000000000000000000000001
10111111111111001111111111110011111111111100111111111111001101
10100000000010001000000000100010000000001000100000000010001001
10101111110010001011111100100010111111001000101111110010001001
10101000010010001010000100100010100001001000101000010010001001
10101011010010001010110100100010101101001000101011010010001001
1010101C0100100010101C0100100010101C0100100010101C010010001001
10101010010010001010100100100010101001001000101010010010001001
10101011110011111010111100111110101111001111101011110011111001
10101000000000000010000000000000100000000000001000000000000001
1P0000111111111111100000000000001111111111111110000000000000E1
10101000000000000010000000000000100000000000001000000000000001
10101011110011111010111100111110101111001111101011110011111001
10101010010010001010100100100010101001001000101010010010001001
1010101C0100100010101C0100100010101C0100100010101C010010001001
10101011010010001010110100100010101101001000101011010010001001
10101000010010001010000100100010100001001000101000010010001001
10101111110010001011111100100010111111001000101111110010001001
10100000000010001000000000100010000000001000100000000010001001
10111111111111001111111111110011111111111100111111111111001101
100000000000000000000000000000000000000000000000000000000000C1
11111111111111111111111111111111111111111111111111111111111111
