1111111111111
10010000000C1
1P0011E000C01
11111111111